***********************************************************
*                                                         *
* *********** ****** * *************                *** * *
*         *** **       ***               ****       *** * *
* *******     ** *** * *** ***           ****   ******* * *
* **      ***    *** * *** *******   ********   ******* * *
* ** ***  ********** * *** ********* ********   ******* * *
*                                                    ** * *
* **                          ******                 ** * *
* *******    *****       *********** ****** *********** * *
* ***                    *********** ****** *********** * *
* ***                                                     *
* ******* ********************** **  ****** *********** * *
*     *** **              *** ** **  **     ***     *** * *
* *** *** ** *****            ** **  ** *** *** *** *** * *
* *** *** ** *****        *** ** **     *** *** *** *** * *
*                                    ****** *** *** *** * *
* *** *** ********************************* *** *** *** * *
*                                                         *
***********************************************************
