******************************************************************************************************************
*                    *************       ********                                   ***********                  *
* ***************    ************* ***** ******** ************** *********** ****** *********** **** *********** *
*       ***     *             **** ***** ******** ************** *********** ****** *********** **** *********** *
* ***** *** *** * *********** ****       ******** ****                       ******             **** *********** *
* ***** *** *** * **       ** ***** **** ******** ****                                                        ** *
* ***** *** *** * ** ***** ** ***** **** ********      ********* *********** ****** *********** *             ** *
* ***** *** *** * ** ***** ** ***** **** ***********   ********* *********** ****** *********** *             ** *
* *****     *** *             *****                              *********** *           ****** **** *********** *
* ************* ***** **** ******** **** ******** ** ******** ** *********** * **** **** ****** **** *********** *
* ************* ***** **** ******** **** ******** ** ******** **             * **** ****             *********** *
*                                   ****                                       **** *********** **** *********** *
****** **** **** ******************                                                                              *
****** **** **** ****************** **** **** *** ** ******** ** * ******* * * **** *********** **** *********** *
****** ****                                       ** ******** ** * ******* * *                                   *
****** ******** ***** ***** * *************** *** ** ******** ** * ******* * * **** **** **** *****  ******* *** *
****** ******** ***** ***** *                     ** ******** ** *         * * **** **** **** *****  ******* *** *
****** ******** ***** ***** * **** ********** *** ** ******** ** ** ***** ** *                               *** *
****** ****     ***** ***** * **** ********** *** ** ******** ** ** ***** ** * **** **** **** *****  ******* *** *
* **** **** ********* ***** * ****            ***                            * ****                  ******* *** *
*                             *********       ********* *********** ***** ** * ********************  ******* *** *
* **** **** ********* ***** * *********       ********* *********** ***** ** * ********************          *** *
*           ********* ***** * ********* *****                                                        *******     *
* **** **** *********                         ********* *********** ***** ************************* ***      *** *
* **** **** ********* ***** ***************** ********* *********** ***** *                         *** **** *** *
* ****                *****                                   ***** ***** * *********************** ***      *** *
* ****             ** ***** ***** ***** *************** ***** ***** ***** *                         ********     *
* ****             ** ***** ***** ***** *************** ***** ***** ***** ************************* *****        *
* ****             ** ***** ***** ***** *************** ***** ***** ***** *                         ***** ** *** *
*                     *****                                   ***** ***** * *********************** *****    *** *
* ******************* ***** ********************************* ***** ***** *                         ******** *** *
*                                                                                                   ******** *** *
* ******************* ***** ********************************* ***** ***** ************************* ******** *** *
*                                                                                                                *
******************************************************************************************************************
