**********************************************************
*                           ****      *        **        *
* * ***** **** ******* * ** ****      * ** *** ** ** *** *
* *   ***            * * **      ***  * ** *** ** ** *   * 
* *** **  **** ***** * * ** **** *** ** **     ** ** * * *
* ***     **** *****     ** **** ***    ** ****** **     *
* *** ** ***** ***** * * ** ****     *****        ** * * *
* *** **     *              **   ***      *** *** ** * * *
*     ** *** * ***** * * ** ** * *** **** *** *** **     *
* *** ** *** * ***** *** ** ** * ******** *** *** ** *** *
*                              *                     *** *
**********************************************************
